....W....
...WXW...
.WWWPWWW.
WPPPPPPPW
WPPPPPPPW
WPPPPPPPW
WPPPPPPPW
WPPPPPPPW
WPPPPPPPW
WPPPPPPPW
.WWWPWWW.
...WNW...
....W....