WWWWW....
WPPPW....
WPWWWWWWW
WPPPPPPPW
WPNPPPPPW
WWWWWWWWW