WWWWW....
WPPPW....
WPWWWWWWW
WPPPPPPXW
WPNPPPPPW
WWWWWWWWW