WWWWWWWWWW
WPPPPPPPXW
WPPPPPPPPW
WPPPPPPPPW
WPPPPPPPPW
WPPPPPPPPW
WPPPPPPPPW
WPPPPPPPPW
WWWNWWWWWW
..WWW.....