WWWWWWWWWW
WPCPPPCPXW
WPPPPPPPPW
WPPPPPPPPW
WPPPPPPPVW
WPPPPPPPPW
WWWDWWWWWW
..WWW.....