WWWWWWWWWW
WPPPPPPPXW
WPPPPPPPPW
WPPPPPPPPW
WPPPPPPPPW
WPPPPPPPPW
WPPPPPPPPW
WPPPPPPPPW
WWWDWWWWWW
..WWW.....