WWWWWWWW
WPCPCPXW
WPPPPPPW
WPPPPPVW
WWWDWWWW
..WWW...